-46
80
-62
49
0000000000011000011111100000000000000000000000011111111110010011000000000000000000000000000000000000000000000000000111111111000
0000000001100011100000001111110111111110111111110000000001110001111111111101111110111111011111111111111111111111111100000001100
0000001111111111111111101000000000000000000000000000000000000000000000000000000000000000000000000000000000000000000000000000100
0000000000000000000000000000000000000000000000000000000000000000000000000000000000000000000000000000000000000000000000000000100
0000000011000000000000000000000000000000110000000000000000000000000000000000000000000000000000000000000000000000000000000000110
0000000011111110011110000000000000000000000000000000000000000000000000000000000000000000000000000000000000000000000000000000010
0000000011000011110110000000000000000000000000000000000000000000000000000000000000000000000000000000000000000000000000000000010
0000000011000000000110000000000000000000000000000000001111000111111111111111111111111111111111111111100000000000000000000000010
0000000011000000000110000000000000000000000000000000110001111111111111110000000000000000001111000001100000000000000000000000010
0000000011000000000110000000000000000000000000000001110000000000000000000000000000000000000000000001100000000000000000000000010
0000000111000111111110000000000000000000000000000111000000000000000000000000000000000000000000000001100000000000000000000000010
0000000111000100000000000000000000000000000000001100000000000000000000000000000000000000000000000001100000000000000000000000010
0000000111000100000000000000000000000000000000011000000000000000000000000000000000000000000000000011100000000000000000000000010
0000000111000100000111111000000000000000000001100000000000000000000000000000000000000000000000000011100000000000000000000000010
0000000110011100011110001000000000000000000001000000000000000000000000000000000000000000000000000011110000000000000000000000010
0000000111111100010000001000000000000000000001000000000000000000000000000000000000000000000000000011110000000000000000000000010
0000000110000000011100001000000000000000000001000000000000000000000000000000000000000000000000000011100000000000000000000000011
0000000110000000011100001000000000000000000001000000000000000000000000000000000000000000000000000011100000000000000000000000001
0000000110000000000111111000000000000000000001000000000000000000000000000000000000000000000000000011100000000000000000000000001
0000000110000000000000000000000000000000000001000000000000000000000000000000000000000000000000000011100000000000000000000000001
0000000100000000000000000000000000000000000001000000000000000000000000000000000000000000000000000011100000000000000000000000001
0000000110000000000000000000000000000000000001000000000000000000000000000000000000000000000000000011100000000000000000000000001
0000000111111111111111100000000000000000000001000000000000000000000000000000000000000000000000000011100000000000000000000000001
0000000110000000000000111000000000000000000011000000000000000000000000000000000000000000000000000011100000000000000000000000001
0000000100000000000000111000000000000000000011100000000000000000000000000000000000000000000000000011100000000000000000000000001
0000000100000000000000001000000000000000000010100000000000000000000000000011111100111111111100000001100000000000000000000000001
0000000100000000000000101000000000000000000010100000000000000000000000011100000111100000011111111001100000000000000000000000010
0000000111111000000001101000000000000000000010100000000000000000000000010000000000000000000000001001100000000000000000000000011
0000000000001100000001111000000000000000000010100000000000000000010000110000000000000000000000001111100000000000000000000000011
0000000000001100000011101000000000000000000010100000000000000000011111110000000000000000000000001111100000000000000000000000001
0000000000001111111101100000000000000000000011100000000000000000010000000000000000000000000000001111100000000000000000000000011
0000000000001100000011110011100000000000000011000000000000000000011111110000000000000000000000001110000000000000000000000000011
0000000000001100001101111110100000000000000011000000000000000000000000010000000000000000000000001100000000000000000000000000011
0000000000000111111000010000110000000000000011000000000000000000000000010000000000000000000000011100000000000000000000000000010
0000000000000000000000110000110000000000000011000000000000000000000000010000000000000000000000011100000000000000000000000000010
0000000000000000000000110000110000000000000011000000000000000000000000010000000000000000000000011100000000000000000000000000010
0000000000000000000000110000110000000000000011000000000000010000000000010000000000000000000000011100000000000000000000000000010
0000000000000000000000110000110000000000000011100000000000011111111111110000000000000000000000011100000000000000000000000000010
0000000000000000000000100000110000000000000011110000000000010000000000000000000000000000000000011100000000000000000000000000010
0000000000000000000000100000110000000000000000000000000000010000000000000000000000000000000000001100000000000000000000000000010
0000000000000000000000100000110000000000000000000000000000010000000000000000000000000000000000001100000000000000000000000000010
0000000000000000000000100000100000000000000000000000000000111111111111010000000000000000000000001100000000000000000000000000010
0000000000000000000000100000100000000000000000000000000000111111111111111000000000000000000000001100000000000000000000000000010
0000000000000000000000100000100000000000000000000000000000000000000000010000000000000000000000001100000000000000000000000000010
0000000000000000000000111111100000000000000000000000000000000000000000010000000000000000000000001100000000000000000000000000010
0000000000000000000000000000000000000000000000000000000000000000000000010000000000011111111111111110000000000000000000000000010
0000000000000000000000000000000000000000000000000000000000000000000011111111111111111111111111111110000000000000000000000000010
0000000000000000000000000000000000000000000000000000000000000000000000000000000000000000000000000000000000000000000000000000010
0000000000000000000000000000000000000000000000000000000000000000000000000000000000000000000000000000000000000000000000000000010
0000000000000000000000000000000000000000000000000000000000000000000000000000000000000000000000000000000000000000000000000000010
0000000000000000000000000000000000000000000000000000000000000000000000000000000000000000000000000000000000000000000000000000010
0000000000000000000000000000000000000000000000000000000000000000000000000000000000000000000000000000000000000000000000000000011
0000000000000000000000000000000000000000000000000000000000000000000000000000000000000000000000000000000000000000000000000000011
0000000000000000000000000000000000000000000000000000000000000000000000000000000000000000000000000000000000000000000000000000011
0000000000000000000000000000000000000000000000000000000000000000000000000000000000000000000000000000000000000000000000000000011
0000000000000000000000000000000000000000000000000000000000000000000000000000000000000000000000000000000000000000000000000000010
0000000000000000000000000000000000000000000000000000000000000000000000000000000000000000000000000000000000000000000000000000110
0000000000000000000000000000000000000000000000000000000000000000000000000000000000000000000000000000000000000000000000000000110
0000000000000000000000000000000000000000000000000000000000000000000000000000000000000000000000000000000000000000000000000000110
0000000000000000000000000000000000000011100000000000000000000000000000000000000000000000000000000000000000000000000000000000110
0000000000000000000000000000000000000011100000000000000000000000000000000000000000000000000000000000000000000000000000000000110
0000000000000000000000000000000001111011100000000000000000000000000000000000000000000000000000000000000000000000000000000000110
0000000000000000000000000000000001110111110000000000000000000000000000000000000000000000000000000000000000000000000000000000100
0000000000000000000000000000000001000000010001111111111111000000000000000000000000000000000000000000000000000000000000000000100
0000000000000000000000011111111111000000011111100011111111000000000000000000000000000000000000000000000000000000000000000000100
1000000000000000000000001000011111000000010001100000000001000000000000000000000000000000000000000000000000000000000000000000100
1000000000000000000000001000001000000000010001100000000001000000000000000000000000000000000000000000000000000000000000000000100
1000000000011111110000001000000000000000000001100000000001000000000000000000000000000000000000000000000000000000000000000000110
1000000000010000010000001000000000000000000001100000000001000000000000000000000000000000000000000000000000000000000000000000101
1000000000110000011111111000000000000000000001100000000011000000000000000000000000000000000000000000000000011111111111111100110
1000000000100000000000001111100000000000000001111111111111000000000000000000000000000000000000000000000000001111101111101100100
0000000000100000000000001000100000000000000000000000000100000000000000000000000000000000000000000000000000001000000000000100100
1000000000100000000000001000100000000000000000000000000100000000000000000000000000000000000000000000000000001000000000001100100
1000000000100000000000001000100000000000000000000000000100000000000000000000000000000000000000000000000110001000000000001000100
1000000000100000000000001000100000000000000000000000000100000000000000000000000000000000011111100000111111001000000000001000100
1000000000100000000000001000100000000000000000000000000100000000000000000000000000000000010000100000100001011111110000111001100
0000000001111111111111001000100000000000000000000001100100000000000000000000000000000000010000100011100001111000010000100001100
0000000000000000000001001000111000000000000000000001111100000000000000000000000000000000010000100010000000010000011111100001100
0000000000000000000001001000111111100000000000000001100111000000000000000000000001111110010000100010000000011100000000000001110
0000000000000000000001001000011100100000000000000001100011000000000000000000000001110010011100100010000000010100000000000000110
1000000000000000000001001000000000100000000000000001100001000000000000000000000001100010010100100010000000000100000000000000111
1000000000000000000001001000000001100000000000000001000011000000000000000000000001100010000111100010000000000100000000000000101
1000000000000000000001001100000001100000000111000001000111000000000000000000000000100010000000000000000000001100000000000000101
0000000000000000000001001100000000111111111001111111000100000000000000000000000000100010000000000000000000001100000000000000111
0000000000000000000001111000000000000000000111111110001100000000000000000000000000100010000000000000000000011100000000000000110
0000000000000000000001111000000000000000000110000001001100000000000000000000000000100011111100000000000111111100000000000000100
0000000000000000000000001000000000000000000100000001001100000000000000000000000000100000000100000000000110000000000000000001000
0000000000000000000000001000000000000000000100000001001100000000000000000000000000100000000100000000000110000000000000000001000
0000000000000000000000001000000000000000000100010111111111000000000000000000000000111111100100000000000110000000000000000010000
0000000000000000000000011111000000000000001111111111000001000000000000000000000000100001110100000000000110000000000000000100000
0000000000000000000000011001000000000000000000000111111111000000000000000000000000000000101111001111110110000000000000000100000
0000000000000000000000011001000000000000000000000001000001000000000000000000000000000000111100000011111110000000000000000000000
0000000000000000000000011001000000000000000000000001000001000000000000000000000000000000000000000000000000000000000000010000000
0000000000000000000000011001000000000000000000000001000001000000000000000000000000000000000000000000000000000000000000100000000
0000000000000000000000011001000000000000000000000001000001000000000000000000000000000000000000000000000000000000000001100000000
0000000000000000000000011111000000000000000000000001000001000000000000000000000000000000000000000000000000000000000010000000000
0000000000000000000000011000000000000000000000000111100001000000000000000000000000000000000000000000000000000000000010000000000
0000000000000000000000011111111111110000011111100110000001000000000000000000000000000000000000000000000000000000001100000000000
0000000000000000000000010000000000010000010001100110000001000000000000000000000000000000000000000000000000000000001000000000000
0000000000000000000000010000000000010001110000100100000001000000000000000000000000000000000000000000000000000000010000000000000
1000000000000000000000010000000000010001000000100111100001000000000000000000000000000000000000000000000000000011100000000000000
1000000000000000000000010000000000011111110000100111100001000000000000000000000000000000000000000000000000000100000000000000000
1000000000000000000000010000000000010000011111100000101111000000000000000000000000000000000000000000000000001000000000000000000
0100000000000000000000011111111111100000111000000000111111000000000000000000000000000011111011100000000001000000000000000000000
0100000000000000000000000000000000000000111000000000000000000000000000000000000000001100000000111111111110000000000000000000000
0100000000000000000000000000000000000000111000000000000000000000000000000000000000011000000000000000000000000000000000000000000
0010000000000000000000000000000000000000000000000000000000000000000000000000000000110000000000000000000000000000000000000000000
0010000000000000000000000000000000011111111110100000000000000000000000000000000001000000000000000000000000000000000000000000000
0011110100000000000000000000000111100000000011011111101000000000000000000000000011000000000000000000000000000000000000000000000
0011001011100000000000000001111000000000000000000000001111000000000000000000000000000000000000000000000000000000000000000000000
0000000000111111111111111110000000000000000000000000000000100000000000000000001000000000000000000000000000000000000000000000000
0000000000000000100010000000000000000000000000000000000000011100000000000000010000000000000000000000000000000000000000000000000
