-9
24
-27
10
0000000000000000000000000000000000
1111111111111111111111111111111110
1000000000000000000000000000000010
1000000000000000000000000000000010
1000110000000001110000000000000010
1000111000001001110000000000000010
1000111000000001110000011101000010
1000000000000000000001011100000010
1000000000000000000000011100000010
1000000000000000000000000000000010
1000000000000000000000000000000010
1010000000000000000000000000000010
1000000000000000000000000000000010
1000000000000000000000000000000010
1000000000000000000000000000000010
1000000000000000000000000000000010
1000000010000000000000000000000010
1000000000000000000000000000000010
1100000000000000000000000000000110
0100000000000000000000000000000100
1100000000000000000000000110000110
1000110000000000000000000111000010
1000111000000000000000000111000010
1000111000000000000000000000000010
1010000000000000000000000000000010
1000000000000000000000000000000010
1000000000000001100000000010000010
1000000000000001110000000000000010
1001110000000001110000000000000010
1001110000000000000000000000000010
1001110000000000000000001110000010
1000000000000000000000001110000010
1000000000000000000000001110000010
1000000001000000000000011110000010
1000000000001100000000001110000010
1000000000111100000000000000000010
1000000000111100000000000000000010
1111111111111111111111111111111110
